111111111111111
1C0100000100E01
100001010100101
111001100000001
1P00010010001C1
111111111111111