1111111111111111111
1C01000001E01000101
100001B1010010B0001
1111011000000000101
10B001C011000100111
1P0001C01C0001B00C1
1111111111111111111