1111111111
1000C00000
10E000C0P1
1111111111