1111111111
1000000001
10E00000P1
1111111111