111111111
11C100001
101E11P01
111111111