11111111
10C00E01
10P001
11111111